joanne	hersey
Danny	Hawkins Jr
Wralyn	Penick
Joseph	Napolitano
Gabriella	Salazar
Sophia	Fernandez
Monica	Porrata
Patricia	Pillsbury
Terry	Faison
Nancy	Cale
Roberta	Lewis
Jason	Baez
Lisa	Catarelli
Justin	Dudley
Ariel	Simmons
Fidel	Garcia
Labridgette	Levi
Anna	Barragan
Rudy	Hernandez
Elena	Walker
Kristin	Castle
Sylvia	Garcia
Daniel	Lemmer
Robin	Davis
Anthony	Lynch
AntonioReset	ByrdReset
Christine	Tewell
Guadalupe	Rodriguez
James	Jamison
Ildar	Shaikhutdinov
Veasna	Chan
Zach	Duckett
Michael	Agoglia
Shanise	Bradley
victorReset	barreraReset
jeffreyReset	mcwilliamsReset
Gloria	Calderon
WilliamReset	EilersReset
Laurencio	Lira
George	Williams
Felipe	Rodriguez Jr
Paul	Crace
James	Mehic
Speed	Vilbar
Nicholas	DeCarlo
Simone	Brown
RitaReset	DelaneyReset
Robert	Yamada
Ronette	Williams
Phil	Pape
Krista	Milligan
Nikol	Ehni
Rhesa	Mcdowell
Katelyn	Gross
Ashleigh	James
Manlio	Salgado
Kristopher	Osborne
RobertReset	RiegleReset
Chase	Brattain
Richard	Maple
benjamin	carlson
Ronald	Magsby
Darryl	Wimer
BernardReset	RowansReset
Teresa	Alioto
VeronicaReset	VegaReset
taicReset	kimReset
Stacy	Robinson
Dominic	Ancona
Jeffrey	Pangaro
Stephen	Depauw
Kennith	Raveneau
Ruben	Aguilar
Kyrie	Taylor
Ribeqah	West
Tobin	Masterson-miller
Michael	Murphy
Justinne	Javate
RickyReset	BellReset
Alex	Leeper
Aaron	Hramiak
Jennifer	Sternal
Heather	Baker
Gene	Olson
Michael	Covington
Kyle	Adkins
Brian	Fazio
ZacharyReset	ClarkReset
Michael	Kamrath
Johnathan	Gieger
Maria	Luna
Freedom	Nkani
Carlos	Velasquez
Deana	Allen
Amanda	Wolf
Brenda	Graham
meysamReset	haghighatReset
Justin	Carey
Baktosh	Moradi
Dominique	Hart
Brandon	Jenkins
Brandilon	Ojeda
Brian	Biglin
Travis	Stemmene
BarryReset	FalchReset
William	Kaszycki
Donnie	Andrews
rizalinoReset	fontanillaReset
Jane	Gandia
Brian	Carter
Steven	Jones
Tou	Yang
Victor	Pellico
David	Jones
Rick	Rollins
Elizabeth	Uriegas
Alejandro	Lozada
Lucero	Panduro
Qiyamah	Miller
Patricia	Jackson
Kum	Hwakim
Daniel	Letzer
Marlon	Montenegro
Scott	Johnson
Lisa	Barnhart
PurnaReset	LukkaReset
Wismine	Joseph
Amanda	Stlawrence
John	Henry
David	Hernandez
Darren	Miller
Douglas	Nyberg
Leanne	Gallick
Raymond	Peyton
Ariella	Angell
Deborah	Rhoades
David	Eastwood
Matthew	Lockamy
Allen	Whitt
Mistie	Warnock
MoranReset	SinghReset
Anthony	Llamas
Derek	Meyers
Tacara	Baumler
MikeReset	LovitschReset
Aprili	Wiggins
Alyssa	Lyle
Lee	Jackson Jr
Carrie	Williams
April	Torrestorija
Allona	Dejean
Janessa	Stancil
Ryan	Gibson
Raymond	Lee
Christopher	Kagelaris
Spencer	Blackburn
RitaReset	DelaneyReset
Patrick	Dispenza
Rachelle	Barger
George	Cassidy
Kristina	Miranda
Nancy	Goodloe
Steven	Cox
GabrielReset	MedinaReset
Jasmine	White
Rodricus	Smith
Richard	Besherse
Alesha	Adkinson
Amy	Sweeden
Ruslan	Khomitskiy
James	Winborn
Derrick	George
RobbieReset	ChristopherReset
Amanda	Roscoe
Vantrelle	Jones
Amber	Leediker
Jocilen	Broyles
TonyaReset	McCarthyReset
Teena	Ennabi
Emmanuel	Hubbard
Pierre	Rimelson
RobertReset	BrooksReset
Patricia	White
Daniel	Thompson
James	Belyeu
Samuel	Luquis
Andrew	Walker
Saquesha	Wilson
Tommy	Cummings
Alfredo	Duenas
Avari	Lloyd
Benjamin	Cammaratta
Michael	Adams
Sean	Graham
Brittani	Holley
Margarita	Alonzo
kennethReset	bennettReset
Laquindra	Thomas
Christian	Shields
Monet	Martinez
Jose	Soriano
Timothy	Moore
Ellen	Azbill
RichardReset	SalesReset
Juston	Lemon
Ivan	Davila
Derrick	Whittier
ReggieReset	GordonReset
MariannaReset	MartinezReset
Alyssa	Dawson
Jeffrey	Palmere
Eric	Williams
chadReset	lightfootReset
Paul	Garcia
CoyReset	BlevinsReset
Jeannie	Carruth
Diane	Nemzek
Ciara	Madere
Jennifor	Belalrd
Wendi	Knight
Andrew	Gallo
Howard	Mills
Rasheed	Brandon
Cynthia	Robbins
Shannon	Harris
Rorcia	Roland
Michael	Nghiem
Ronveecia	Irving
Floyd	Turner
Michael	Maslana
Helen	Youmans
Tiffany	Walker
GregoryReset	ScholomReset
Elvis	Crnovrsanin
Rohana	Shirley
Taiisha	Sykes
Kevin	Booker
Deion	Simmons
Ben	Steffani
Tyler	Wolterman
Joseph	Gauthier
Oscar	Ocaranza
Barbara	Smith
Susan	Manns
Everett	Jackson
MichalReset	LawryReset
Debra	Neal
Maria	Lopez
Mario	Whiteside
Samantha	Crafton
Wesley	Niemiec
Dave	Laabs
Alma	Tyson
Nat	Atapoor
Sharon	Cole
Linda	Horne
Constance	Venegoni
Tom	Jones
Wendy	Estrada
Jon	Pedersen
Sabino	Jimenez
Joshua	Stearns
Clayton	White
Timothy	Wagner
Jay	Forsythe
Melisa	Stanley
WilliamReset	BoydReset
Jimmy	Halsell
Anita	Hunter
Chelsey	Matlock
Amanda	Shepit
Mandy	Uieda
Naveen	Vemulapalli
Kristin	Martin
AmyReset	ZimmermanReset
Lovesa	Leonard
Justin	Buck
Tyler	Edwards
Jose	Vazquez
David	Diaz
Omar	Alas
Sue	Walker
Larry	Chappell
Soledad	Padilla
Alonso	Duran
Tony	Svoboda
Andrew	Manson
Evalina	Ramirez
Ingrid	Richardson
Kendall	Daniels
Michael	Ridgway
John	Sheets
Henry	Sorge
Diriye	Shire
Yvonne	Barraza
Scott	Holland
Jessica	Norville
Denisha	Forte
Zachary	Jobes
Bridget	Javius